XXXXXXXX
XX    XX
XX XX XX
X  XE XX
XX XX  X
X   XXXX
XXX    X
XXXXXX S