EXXXXXXX
 X    XX
 XXXX XX
   XS XX
XX XX  X
X   XX X
XXX    X
XXXXXX X