SXXX XXX
 X   XXX
 XXX   X
 XXX XXX
        
X XXXXX 
X      X
X XXXX E
